The default locale is:
en_US => English (United States) [English (United States)]
The available locales are:
ar => Arabic [???????]
be => Belarusian [?????????]
bg => Bulgarian [?????????]
ca => Catalan [català]
cs => Czech [?e?tina]
da => Danish [Dansk]
de => German [Deutsch]
el => Greek [????????]
en => English [English]
es => Spanish [español]
et => Estonian [Eesti]
fi => Finnish [suomi]
fr => French [français]
ga => Irish [Gaeilge]
hr => Croatian [hrvatski]
hu => Hungarian [magyar]
in => Indonesian [Bahasa Indonesia]
is => Icelandic [íslenska]
it => Italian [italiano]
iw => Hebrew [?????]
ja => Japanese [???]
ko => Korean [???]
lt => Lithuanian [Lietuvi?]
lv => Latvian [Latvie?u]
mk => Macedonian [??????????]
ms => Malay [Bahasa Melayu]
mt => Maltese [Malti]
nl => Dutch [Nederlands]
no => Norwegian [norsk]
pl => Polish [polski]
pt => Portuguese [português]
ro => Romanian [român?]
ru => Russian [???????]
sk => Slovak [Sloven?ina]
sl => Slovenian [Sloven??ina]
sq => Albanian [shqipe]
sr => Serbian [??????]
sv => Swedish [svenska]
th => Thai [???]
tr => Turkish [Türkçe]
uk => Ukrainian [??????????]
vi => Vietnamese [Ti?ng Vi?t]
zh => Chinese [??]
